1  1  1  1  1  1  1  1  1  1  1  1  1  1  1
1  8  0  0  0  0  0  6  0  0  0  0  0  8  1
1  0  3  0  3  0  0  0  0  0  0  0  0  0  1
1  0  0  3  0  0  0  0  0  0  3  3  3  0  1
1  0  3  0  3  0  0  0  0  0  3  0  3  0  1
1  0  0  0  0  0  0  0  0  0  3  3  3  0  1
1  0  0  0  0  0  0  3  0  0  0  0  0  0  1
1  0  0  0  0  0  3  3  3  0  0  0  0  0  1
1  0  0  0  0  0  0  3  0  0  0  0  0  0  1
1  0  3  3  3  0  0  0  0  0  3  0  3  0  1
1  7  3  0  3  0  0  0  0  0  0  3  0  7  1
1  0  3  3  3  0  0  0  0  0  3  0  3  0  1
1  0  0  0  0  0  4  4  4  0  0  0  0  0  1
1  0  0  0  0  0  4  2  4  0  0  0  0  0  1
1  1  1  1  1  1  1  1  1  1  1  1  1  1  1
