1  1  1  1  1  1  1  1  1  1  1  1  1  1  1
1  6  0  0  7  0  0  0  0  0  8  0  0  9  1
1  0  3  3  3  0  0  0  0  0  0  0  3  0  1
1  0  0  0  0  0  0  0  0  0  0  3  0  0  1
1  0  0  0  0  0  0  0  0  0  3  0  0  0  1
1  0  0  0  0  0  0  0  0  0  0  0  0  0  1
1  0  0  3  3  3  3  0  0  0  0  0  0  0  1
1  0  0  0  0  0  0  0  0  0  0  0  0  0  1
1  0  0  0  0  0  0  0  0  0  0  3  0  0  1
1  0  0  0  0  0  0  0  0  0  0  3  0  0  1
1  0  0  0  3  0  0  0  0  0  0  3  0  0  1
1  0  0  3  0  0  0  0  0  0  0  0  0  0  1
1  0  3  0  0  0  4  4  4  0  0  0  0  0  1
1  0  0  0  0  0  4  2  4  0  0  0  0  0  1
1  1  1  1  1  1  1  1  1  1  1  1  1  1  1
